11111111111
1C000000001
1000000X001
1X0000000E1
100X000C001
10000000P01
1C000X000C1
11111111111
