1111111
1000P01
000E001
10000C1
1111111
