11111
10P01
10E01
101C1
11111
