111111111111111111111111111111111111111
100000000E0000000P00000000C000000000001
111111111111111111111111111111111111111
