11111111111
1C000000001
10000000001
1P0000000E1
10000010001
10000000001
10000000001
11111111111
