11111111111111111111
10000000000000000001
1000C000000000000001
1000000000000E000001
10000000C000000C0001
10000000000000000001
100000000P0000000001
100000000000C0000C01
11111111111111111111
